H2HHHHHHHHHHHHHHHHHH
H_HHHHHHH__________H
H_HHHHHHHHHHHHHHHH_H
H__________________H
HHHH_HHHHHHHHHHH_HHH
HHHH_HHHH____HHH_HHH
HHHH___HH_HH_____HHH
HHHHHH_HH_HHHHHHHHHH
H____H_HH_HH_HHHHHHH
H_HH_H_HH_HH_HHHHHHH
H_HH_H_HH________HHH
H_HH_H_HHH_HHHHH_HHH
H_HH_H_HHH_HH_HH_HHH
H_HH_H_HHH_HH_HH_HHH
H_HH_H_HHH____HH__HH
H_HH_H_HHHHHHHHHH_HH
H_HH_H__________H_HH
H_HH_HHHHHHHHHH_H_HH
H_HH____________H_HH
HFHHHHHHHHHHHHHHHHHH
